30
000
001
002
003
004
005
006
007
008
009
010
011
012
013
014
015
016
017
018
019
020
021
022
023
024
025
026
027
028
029
30
000 001 -1 0 0 0 0 0
001 002 -1 0 0 0 0 0
002 003 -1 0 0 0 0 0
003 004 -1 0 0 0 0 0
004 000 -1 0 0 0 0 0
001 005 1 0 0 0 0 0
001 006 1 0 0 0 0 0
001 007 1 0 0 0 0 0
001 008 1 0 0 0 0 0
001 009 1 0 0 0 0 0
001 010 1 0 0 0 0 0
002 011 1 0 0 0 0 0
002 012 1 0 0 0 0 0
002 013 1 0 0 0 0 0
002 014 1 0 0 0 0 0
002 015 1 0 0 0 0 0
002 016 1 0 0 0 0 0
003 017 1 0 0 0 0 0
003 018 1 0 0 0 0 0
003 019 1 0 0 0 0 0
003 020 1 0 0 0 0 0
003 021 1 0 0 0 0 0
003 022 1 0 0 0 0 0
004 023 1 0 0 0 0 0
004 024 1 0 0 0 0 0
004 025 1 0 0 0 0 0
004 026 1 0 0 0 0 0
004 027 1 0 0 0 0 0
004 028 1 0 0 0 0 0
004 029 1 0 0 0 0 0
